NO ./images/NORTH.xpm
SO ./images/SOUTH.xpm
WE ./images/WEST.xpm
EA ./images/EAST.xpm
F 220,100,11
C 225,30,13

111111
100101
101001
1100N1
111111
