NO ./images/north.xpm
SO ./images/south.xpm
WE ./images/west.xpm
EA ./images/east.xpm
C 80,188,224
F 150,150,150

111111111111111111111111111111
11111000000000100000000001000011
100100000000000000000000000000001111
10100000100000001000000001000000001 
1100N0001000111100000000010000000001
11111100000000000000000010000001011
111111111111111111111111111111111
