NO ./images/north.xpm
SO ./images/south.xpm
WE ./images/west.xpm
EA ./images/east.xpm
C 10,55,17
F 14,180,252

111111
100101
101001
1100N1
111111
