N .
S .
W .
E .
F 1, 255, 255
C 2, 5, 5
1000001
1000001
100S001
1111111 1111
