NO ./images/north.xpm
SO ./images/south.xpm
WE ./images/west.xpm
EA ./images/east.xpm
F 220,100,0
C 225,30,0

1111111
100000
1000001
1111001
10000S1
1111111
