N ./path_to_the_north_texture
S ./path_to_the_south_texture
W ./path_to_the_south_texture
E ./path_to_the_south_texture
F 220,100,0
C 225,30,0

1111111
1000000
1000001
1111001
1000001
1111111
