NO ./images/north.xpm
SO ./images/south.xpm
WE ./images/west.xpm
EA ./images/east.xpm
F 220,100,0
C 225,30,0

1111111
1000001 1111
1000001 1001
1111001 1001
1000001 1S01
1111111 1111
